Rk,Team,G,MP,FG,FGA,FG%,3P,3PA,3P%,2P,2PA,2P%,FT,FTA,FT%,ORB,DRB,TRB,AST,STL,BLK,TOV,PF,PTS,PA/G
1,Boston Celtics*,82,19780,2768,6371,0.434,443,1304,0.34,2325,5067,0.459,1494,1975,0.756,862,2387,3249,1533,574,364,1262,1659,7473,91.1
2,Chicago Bulls*,82,19830,2805,6523,0.43,427,1308,0.326,2378,5215,0.456,1450,1898,0.764,828,2322,3150,1556,568,477,1159,1645,7487,91.3
3,Milwaukee Bucks,82,19830,2834,6342,0.447,437,1309,0.334,2397,5033,0.476,1498,1946,0.77,836,2629,3465,1657,507,392,1245,1694,7603,92.7
4,Orlando Magic*,82,19830,2865,6569,0.436,516,1476,0.35,2349,5093,0.461,1441,1940,0.743,805,2450,3255,1646,606,310,1136,1791,7687,93.7
5,New Orleans Hornets*,82,19830,2882,6306,0.457,557,1562,0.357,2325,4744,0.49,1390,1805,0.77,769,2457,3226,1739,497,396,1192,1674,7711,94
6,Miami Heat*,82,19780,2869,6614,0.434,546,1584,0.345,2323,5030,0.462,1473,1980,0.744,864,2349,3213,1651,574,246,1081,1788,7757,94.6
7,Portland Trail Blazers*,82,19805,2904,6218,0.467,529,1440,0.367,2375,4778,0.497,1434,1869,0.767,868,2385,3253,1573,566,339,1286,1743,7771,94.8
8,Los Angeles Lakers*,82,19830,3008,6888,0.437,558,1668,0.335,2450,5220,0.469,1246,1628,0.765,1002,2399,3401,1827,585,372,1116,1700,7820,95.4
9,Atlanta Hawks*,82,19730,3009,6537,0.46,459,1358,0.338,2550,5179,0.492,1380,1782,0.774,839,2488,3327,1751,548,348,1026,1517,7857,95.8
10,Dallas Mavericks*,82,19705,2996,6656,0.45,508,1480,0.343,2488,5176,0.481,1373,1830,0.75,880,2459,3339,1689,623,303,1114,1650,7873,96
11,Charlotte Bobcats,82,19805,2956,6492,0.455,577,1609,0.359,2379,4883,0.487,1489,1908,0.78,804,2446,3250,1777,601,496,1082,1730,7978,97.3
12,Philadelphia 76ers*,82,19930,2996,6638,0.451,468,1375,0.34,2528,5263,0.48,1536,1987,0.773,881,2608,3489,1762,583,376,1168,1544,7996,97.5
13,Memphis Grizzlies*,82,19880,2967,6489,0.457,587,1592,0.369,2380,4897,0.486,1482,1948,0.761,905,2387,3292,1724,613,505,1367,1754,8003,97.6
14,San Antonio Spurs*,82,19780,3127,6860,0.456,479,1305,0.367,2648,5555,0.477,1301,1698,0.766,884,2494,3378,1685,567,374,1095,1701,8034,98
15,New Jersey Nets,82,20005,3069,6602,0.465,507,1393,0.364,2562,5209,0.492,1589,2115,0.751,849,2575,3424,1824,561,375,1010,1638,8234,100.4
16,Detroit Pistons,82,19880,3110,6405,0.486,523,1461,0.358,2587,4944,0.523,1503,1962,0.766,866,2470,3336,1910,568,381,1160,1545,8246,100.6
17,Indiana Pacers*,82,19780,3071,6837,0.449,511,1423,0.359,2560,5414,0.473,1618,2157,0.75,931,2618,3549,1670,615,467,1143,1758,8271,100.9
18,Oklahoma City Thunder*,82,20005,3123,6823,0.458,482,1335,0.361,2641,5488,0.481,1557,2093,0.744,932,2395,3327,1712,587,356,1152,1767,8285,101
19,Utah Jazz,82,19880,2967,6460,0.459,592,1573,0.376,2375,4887,0.486,1777,2285,0.778,925,2426,3351,1700,609,411,1199,1802,8303,101.3
20,Los Angeles Clippers,82,19855,3046,6688,0.455,584,1598,0.365,2462,5090,0.484,1670,2167,0.771,914,2410,3324,1827,659,404,1125,1811,8346,101.8
21,Denver Nuggets*,82,19705,3153,6876,0.459,576,1675,0.344,2577,5201,0.495,1539,2036,0.756,864,2525,3389,1820,611,488,1127,1864,8421,102.7
22,Houston Rockets,82,19880,3266,6979,0.468,448,1250,0.358,2818,5729,0.492,1526,1954,0.781,955,2552,3507,1707,588,449,1125,1754,8506,103.7
23,Cleveland Cavaliers,82,19755,3232,6804,0.475,664,1614,0.411,2568,5190,0.495,1438,1894,0.759,894,2676,3570,1984,619,489,1111,1747,8566,104.5
24,Sacramento Kings,82,19855,3260,6826,0.478,480,1353,0.355,2780,5473,0.508,1589,2085,0.762,868,2508,3376,1779,666,464,1204,1723,8589,104.7
25,Washington Wizards,82,19930,3174,6741,0.471,560,1500,0.373,2614,5241,0.499,1676,2202,0.761,994,2607,3601,1898,624,413,1293,1662,8584,104.7
26,Toronto Raptors,82,19780,3213,6668,0.482,541,1438,0.376,2672,5230,0.511,1672,2175,0.769,912,2457,3369,1854,625,456,1141,1620,8639,105.4
27,Golden State Warriors,82,19830,3173,6788,0.467,567,1586,0.358,2606,5202,0.501,1755,2262,0.776,1051,2623,3674,2029,672,352,1324,1512,8668,105.7
28,New York Knicks*,82,19780,3242,6870,0.472,536,1442,0.372,2706,5428,0.499,1650,2165,0.762,964,2646,3610,1682,586,360,1250,1703,8670,105.7
29,Phoenix Suns,82,20005,3309,7018,0.472,585,1595,0.367,2724,5423,0.502,1481,1964,0.754,985,2647,3632,1890,644,356,1189,1740,8684,105.9
30,Minnesota Timberwolves,82,19780,3230,6902,0.468,639,1707,0.374,2591,5195,0.499,1733,2227,0.778,913,2577,3490,2031,777,447,1183,1717,8832,107.7