Rk,Team,G,MP,FG,FGA,FG%,3P,3PA,3P%,2P,2PA,2P%,FT,FTA,FT%,ORB,DRB,TRB,AST,STL,BLK,TOV,PF,PTS,PA/G
1,Chicago Bulls*,66,15940,2284,5420,0.421,305,939,0.325,1979,4481,0.442,946,1279,0.74,750,1889,2639,1245,490,343,876,1166,5819,88.2
2,Boston Celtics*,66,15940,2207,5262,0.419,344,1117,0.308,1863,4145,0.449,1138,1498,0.76,781,2070,2851,1233,515,304,1035,1217,5896,89.3
3,Philadelphia 76ers*,66,15915,2263,5302,0.427,357,1070,0.334,1906,4232,0.45,1017,1352,0.752,706,2181,2887,1293,391,316,918,1070,5900,89.4
4,Miami Heat*,66,16040,2285,5267,0.434,479,1318,0.363,1806,3949,0.457,1056,1457,0.725,727,1897,2624,1297,549,280,1107,1356,6105,92.5
5,Memphis Grizzlies*,66,15940,2278,5132,0.444,417,1209,0.345,1861,3923,0.474,1163,1522,0.764,729,1954,2683,1274,518,363,1130,1275,6136,93
6,Atlanta Hawks*,66,16165,2380,5366,0.444,391,1137,0.344,1989,4229,0.47,997,1324,0.753,712,2079,2791,1354,494,313,999,1263,6148,93.2
7,Orlando Magic*,66,15965,2372,5287,0.449,414,1192,0.347,1958,4095,0.478,1005,1302,0.772,667,2061,2728,1350,495,273,867,1308,6163,93.4
8,New Orleans Hornets,66,15940,2305,5188,0.444,425,1342,0.317,1880,3846,0.489,1129,1487,0.759,731,1910,2641,1379,523,380,915,1235,6164,93.4
9,Toronto Raptors,66,15965,2234,5130,0.435,401,1224,0.328,1833,3906,0.469,1335,1795,0.744,677,1997,2674,1327,478,322,870,1214,6204,94
10,Indiana Pacers*,66,15990,2305,5304,0.435,442,1259,0.351,1863,4045,0.461,1179,1617,0.729,794,1998,2792,1292,433,398,985,1428,6231,94.4
11,New York Knicks*,66,15940,2316,5238,0.442,444,1238,0.359,1872,4000,0.468,1171,1590,0.736,717,2045,2762,1248,536,334,1125,1437,6247,94.7
12,Dallas Mavericks*,66,16065,2347,5390,0.435,473,1368,0.346,1874,4022,0.466,1092,1456,0.75,725,2173,2898,1351,561,265,971,1213,6259,94.8
13,Los Angeles Clippers*,66,15965,2279,5098,0.447,460,1261,0.365,1819,3837,0.474,1251,1678,0.746,712,1914,2626,1368,396,296,966,1401,6269,95
14,Detroit Pistons,66,15965,2378,5147,0.462,395,1114,0.355,1983,4033,0.492,1162,1518,0.765,703,1985,2688,1485,563,348,959,1283,6313,95.7
15,Los Angeles Lakers*,66,16065,2492,5703,0.437,443,1274,0.348,2049,4429,0.463,901,1215,0.742,758,1946,2704,1446,556,302,745,1332,6328,95.9
16,San Antonio Spurs*,66,15940,2512,5560,0.452,412,1166,0.353,2100,4394,0.478,932,1233,0.756,680,2039,2719,1291,489,330,906,1244,6368,96.5
17,Oklahoma City Thunder*,66,15990,2405,5629,0.427,421,1231,0.342,1984,4398,0.451,1167,1519,0.768,835,1889,2724,1312,542,321,937,1322,6398,96.9
18,Portland Trail Blazers,66,15965,2476,5349,0.463,442,1217,0.363,2034,4132,0.492,1062,1421,0.747,730,2062,2792,1392,499,314,982,1306,6456,97.8
19,Houston Rockets,66,16065,2474,5427,0.456,369,1136,0.325,2105,4291,0.491,1142,1490,0.766,729,2027,2756,1321,495,340,972,1215,6459,97.9
20,Washington Wizards,66,15865,2422,5352,0.453,426,1216,0.35,1996,4136,0.483,1227,1618,0.758,811,2062,2873,1420,520,300,1004,1231,6497,98.4
21,Phoenix Suns,66,15840,2505,5510,0.455,398,1131,0.352,2107,4379,0.481,1100,1444,0.762,802,2064,2866,1416,526,288,929,1293,6508,98.6
22,Milwaukee Bucks,66,15865,2449,5453,0.449,438,1247,0.351,2011,4206,0.478,1181,1535,0.769,813,2138,2951,1433,499,297,1049,1278,6517,98.7
23,Utah Jazz*,66,16165,2403,5310,0.453,428,1259,0.34,1975,4051,0.488,1302,1727,0.754,728,1988,2716,1355,494,375,968,1366,6536,99
24,New Jersey Nets,66,15890,2501,5294,0.472,431,1151,0.374,2070,4143,0.5,1106,1494,0.74,780,2032,2812,1539,525,330,943,1274,6539,99.1
25,Minnesota Timberwolves,66,15940,2572,5656,0.455,406,1195,0.34,2166,4461,0.486,1059,1402,0.755,771,2096,2867,1422,549,377,875,1435,6609,100.1
26,Cleveland Cavaliers,66,15965,2536,5431,0.467,448,1236,0.362,2088,4195,0.498,1095,1464,0.748,752,2073,2825,1527,524,409,917,1381,6615,100.2
27,Charlotte Bobcats,66,15890,2568,5411,0.475,406,1142,0.356,2162,4269,0.506,1115,1486,0.75,778,2193,2971,1537,499,378,890,1341,6657,100.9
28,Golden State Warriors,66,15915,2461,5431,0.453,468,1281,0.365,1993,4150,0.48,1288,1725,0.747,869,2157,3026,1527,499,328,978,1095,6678,101.2
29,Denver Nuggets*,66,16040,2541,5569,0.456,571,1489,0.383,1970,4080,0.483,1029,1356,0.759,730,1928,2658,1528,524,439,1028,1452,6682,101.2
30,Sacramento Kings,66,15915,2668,5609,0.476,439,1236,0.355,2229,4373,0.51,1118,1468,0.762,815,2154,2969,1571,518,423,1014,1313,6893,104.4