Rk,Team,G,MP,FG,FGA,FG%,3P,3PA,3P%,2P,2PA,2P%,FT,FTA,FT%,ORB,DRB,TRB,AST,STL,BLK,TOV,PF,PTS,PS_G
1,Phoenix Suns,82,19755,3373,6695,0.504,553,1445,0.383,2820,5250,0.537,1675,2251,0.744,900,2520,3420,1905,589,420,1288,1691,8974,109.4
2,Golden State Warriors,82,19880,3231,7055,0.458,550,1475,0.373,2681,5580,0.48,1893,2392,0.791,953,2492,3445,1711,638,527,1201,1842,8905,108.6
3,Los Angeles Lakers*,82,19780,3307,6981,0.474,547,1516,0.361,2760,5465,0.505,1607,2087,0.77,1015,2587,3602,1908,718,420,1103,1698,8768,106.9
4,New York Knicks,82,19805,3157,7091,0.445,823,2284,0.36,2334,4807,0.486,1490,1900,0.784,911,2545,3456,1738,610,204,1174,1672,8627,105.2
5,Indiana Pacers,82,19830,3220,7080,0.455,652,1725,0.378,2568,5355,0.48,1525,1890,0.807,924,2661,3585,1775,573,434,1189,1895,8617,105.1
6,Denver Nuggets*,82,19730,3058,6510,0.47,548,1477,0.371,2510,5033,0.499,1891,2487,0.76,905,2507,3412,1820,710,492,1257,1874,8555,104.3
7,Utah Jazz*,82,19880,3143,6623,0.475,392,1122,0.349,2751,5501,0.5,1814,2352,0.771,940,2423,3363,2024,719,374,1210,1830,8492,103.6
8,Chicago Bulls*,82,19930,3126,6846,0.457,493,1293,0.381,2633,5553,0.474,1633,2052,0.796,970,2481,3451,1732,615,453,1192,1709,8378,102.2
9,Dallas Mavericks*,82,19805,3128,6770,0.462,571,1632,0.35,2557,5138,0.498,1516,1852,0.819,909,2595,3504,1779,591,429,1043,1600,8343,101.7
10,Orlando Magic*,82,19730,2929,6416,0.457,817,2147,0.381,2112,4269,0.495,1611,2253,0.715,819,2728,3547,1593,570,439,1142,1664,8286,101
11,Boston Celtics*,82,19880,3075,6333,0.486,538,1355,0.397,2537,4978,0.51,1587,2075,0.765,869,2586,3455,1862,621,387,1280,1897,8275,100.9
12,Sacramento Kings,82,19905,2990,6685,0.447,586,1594,0.368,2404,5091,0.472,1682,2107,0.798,840,2366,3206,1619,569,349,1266,1910,8248,100.6
13,Cleveland Cavaliers*,82,19780,3022,6454,0.468,656,1670,0.393,2366,4784,0.495,1523,2012,0.757,886,2574,3460,1663,593,435,1045,1663,8223,100.3
14,Portland Trail Blazers*,82,19830,3018,6494,0.465,596,1555,0.383,2422,4939,0.49,1521,1988,0.765,1060,2360,3420,1667,550,402,1055,1671,8153,99.4
15,Milwaukee Bucks,82,19780,3009,6755,0.445,511,1408,0.363,2498,5347,0.467,1613,2067,0.78,973,2367,3340,1802,609,308,1154,1986,8142,99.3
16,Toronto Raptors,82,19805,3054,6673,0.458,479,1289,0.372,2575,5384,0.478,1534,1861,0.824,802,2513,3315,1835,523,390,1098,1593,8121,99
17,Houston Rockets*,82,19805,2959,6526,0.453,621,1656,0.375,2338,4870,0.48,1531,1903,0.805,862,2662,3524,1662,548,355,1158,1553,8070,98.4
18,Miami Heat*,82,19955,3034,6646,0.457,582,1631,0.357,2452,5015,0.489,1411,1871,0.754,828,2411,3239,1671,651,451,1026,1696,8061,98.3
19,New Jersey Nets,82,19830,2925,6536,0.448,652,1735,0.376,2273,4801,0.473,1542,1980,0.779,850,2415,3265,1636,559,391,1075,1838,8044,98.1
20,Atlanta Hawks*,82,19705,2956,6451,0.458,597,1633,0.366,2359,4818,0.49,1537,2085,0.737,870,2412,3282,1657,603,376,1048,1610,8046,98.1
21,Minnesota Timberwolves,82,19805,2986,6766,0.441,543,1539,0.353,2443,5227,0.467,1504,1957,0.769,975,2442,3417,1674,512,322,1165,1785,8019,97.8
22,Philadelphia 76ers*,82,19755,2997,6532,0.459,341,1072,0.318,2656,5460,0.486,1652,2216,0.745,1039,2336,3375,1647,658,415,1157,1650,7987,97.4
23,Oklahoma City Thunder,82,19805,2999,6716,0.447,328,949,0.346,2671,5767,0.463,1626,2069,0.786,999,2497,3496,1663,608,371,1330,1655,7952,97
24,San Antonio Spurs*,82,19905,3042,6534,0.466,625,1620,0.386,2417,4914,0.492,1249,1641,0.761,728,2638,3366,1736,474,329,963,1546,7958,97
25,Washington Wizards,82,19705,2994,6655,0.45,395,1198,0.33,2599,5457,0.476,1494,1948,0.767,956,2330,3286,1641,619,365,1146,1679,7877,96.1
26,New Orleans Hornets*,82,19755,2911,6366,0.457,556,1526,0.364,2355,4840,0.487,1479,1833,0.807,802,2453,3255,1609,593,338,1029,1665,7857,95.8
27,Los Angeles Clippers,82,19880,2955,6696,0.441,535,1513,0.354,2420,5183,0.467,1354,1839,0.736,890,2377,3267,1723,572,482,1221,1650,7799,95.1
28,Detroit Pistons*,82,19905,2981,6559,0.454,377,1079,0.349,2604,5480,0.475,1388,1849,0.751,949,2448,3397,1689,493,377,973,1712,7727,94.2
29,Memphis Grizzlies,82,19805,2865,6311,0.454,398,1106,0.36,2467,5205,0.474,1570,2077,0.756,847,2337,3184,1423,615,385,1252,1777,7698,93.9
30,Charlotte Bobcats,82,19930,2866,6299,0.455,490,1339,0.366,2376,4960,0.479,1455,1965,0.74,886,2366,3252,1741,580,397,1279,1754,7677,93.6