Rk,Team,G,MP,FG,FGA,FG%,3P,3PA,3P%,2P,2PA,2P%,FT,FTA,FT%,ORB,DRB,TRB,AST,STL,BLK,TOV,PF,PTS,PA/G
1,Charlotte Bobcats*,82,19880,2925,6536,0.448,573,1696,0.338,2352,4840,0.486,1270,1710,0.743,868,2382,3250,1666,614,502,1256,1804,7693,93.8
2,Miami Heat*,82,19880,2813,6408,0.439,524,1531,0.342,2289,4877,0.469,1577,2091,0.754,856,2483,3339,1545,517,355,1184,1639,7727,94.2
3,Portland Trail Blazers*,82,19855,2950,6352,0.464,480,1399,0.343,2470,4953,0.499,1394,1870,0.745,801,2322,3123,1583,485,333,1104,1767,7774,94.8
4,Orlando Magic*,82,19730,2955,6739,0.438,522,1437,0.363,2433,5302,0.459,1380,1830,0.754,800,2481,3281,1550,551,288,1050,1819,7812,95.3
5,Boston Celtics*,82,19780,2880,6390,0.451,470,1375,0.342,2410,5015,0.481,1606,2152,0.746,868,2418,3286,1585,578,386,1283,1777,7836,95.6
6,Cleveland Cavaliers*,82,19780,2935,6633,0.442,524,1511,0.347,2411,5122,0.471,1444,1907,0.757,794,2366,3160,1661,542,325,1045,1708,7838,95.6
7,Milwaukee Bucks*,82,19980,2870,6361,0.451,438,1276,0.343,2432,5085,0.478,1692,2211,0.765,790,2722,3512,1581,573,421,1254,1664,7870,96
8,San Antonio Spurs*,82,19780,3025,6691,0.452,412,1200,0.343,2613,5491,0.476,1433,1896,0.756,814,2427,3241,1576,567,417,1032,1672,7895,96.3
9,Atlanta Hawks*,82,19855,3048,6623,0.46,480,1392,0.345,2568,5231,0.491,1380,1852,0.745,922,2471,3393,1719,506,359,1135,1582,7956,97
10,Los Angeles Lakers*,82,19830,3050,6840,0.446,520,1585,0.328,2530,5255,0.481,1332,1776,0.75,914,2546,3460,1792,573,363,1159,1737,7952,97
11,Oklahoma City Thunder*,82,19805,3007,6718,0.448,481,1414,0.34,2526,5304,0.476,1541,2018,0.764,937,2397,3334,1618,616,384,1238,1755,8036,98
12,Utah Jazz*,82,19755,2908,6471,0.449,552,1559,0.354,2356,4912,0.48,1741,2286,0.762,837,2376,3213,1628,632,445,1238,1818,8109,98.9
13,Chicago Bulls*,82,19905,3043,6885,0.442,584,1680,0.348,2459,5205,0.472,1457,1958,0.744,916,2589,3505,1715,578,438,1090,1643,8127,99.1
14,Detroit Pistons,82,19780,2965,6172,0.48,568,1514,0.375,2397,4658,0.515,1630,2124,0.767,814,2420,3234,1898,549,401,1174,1702,8128,99.1
15,Dallas Mavericks*,82,19880,3107,6805,0.457,525,1515,0.347,2582,5290,0.488,1402,1849,0.758,922,2592,3514,1659,563,337,1195,1652,8141,99.3
16,Washington Wizards,82,19830,3083,6664,0.463,528,1466,0.36,2555,5198,0.492,1590,2088,0.761,935,2530,3465,1772,569,415,1115,1684,8284,101
17,New Jersey Nets,82,19780,3172,6593,0.481,468,1278,0.366,2704,5315,0.509,1511,2021,0.748,925,2683,3608,1960,638,421,1149,1647,8323,101.5
18,Philadelphia 76ers,82,19805,3105,6573,0.472,606,1542,0.393,2499,5031,0.497,1518,1983,0.766,888,2470,3358,1810,621,332,1189,1534,8334,101.6
19,Los Angeles Clippers,82,19705,3193,6792,0.47,529,1457,0.363,2664,5335,0.499,1455,1910,0.762,879,2490,3369,1926,686,363,1059,1588,8370,102.1
20,Denver Nuggets*,82,19780,3088,6766,0.456,523,1498,0.349,2565,5268,0.487,1695,2207,0.768,955,2513,3468,1723,578,438,1235,1943,8394,102.4
21,New Orleans Hornets,82,19830,3250,6730,0.483,539,1517,0.355,2711,5213,0.52,1383,1841,0.751,870,2586,3456,1925,574,367,1177,1597,8422,102.7
22,Houston Rockets,82,19905,3236,6810,0.475,489,1344,0.364,2747,5466,0.503,1464,1917,0.764,875,2632,3507,1716,597,532,1207,1840,8425,102.7
23,Indiana Pacers,82,19705,3113,6875,0.453,510,1405,0.363,2603,5470,0.476,1774,2346,0.756,969,2852,3821,1694,654,414,1227,1709,8510,103.8
24,Memphis Grizzlies,82,19905,3277,6849,0.478,572,1618,0.354,2705,5231,0.517,1402,1858,0.755,907,2349,3256,1875,635,501,1165,1840,8528,104
25,Sacramento Kings,82,19880,3199,6828,0.469,497,1391,0.357,2702,5437,0.497,1663,2149,0.774,909,2538,3447,1683,586,468,1120,1650,8558,104.4
26,Phoenix Suns*,82,19730,3235,7165,0.452,561,1582,0.355,2674,5583,0.479,1606,2114,0.76,1081,2391,3472,1704,646,365,1065,1789,8637,105.3
27,Toronto Raptors,82,19780,3194,6824,0.468,609,1665,0.366,2585,5159,0.501,1683,2146,0.784,933,2453,3386,1889,580,360,1040,1730,8680,105.9
28,New York Knicks,82,19880,3352,6902,0.486,553,1571,0.352,2799,5331,0.525,1429,1896,0.754,959,2724,3683,1723,585,368,1182,1576,8686,105.9
29,Minnesota Timberwolves,82,19780,3343,6961,0.48,618,1690,0.366,2725,5271,0.517,1534,1981,0.774,917,2640,3557,2103,721,442,1173,1686,8838,107.8
30,Golden State Warriors,82,19730,3409,7033,0.485,567,1514,0.375,2842,5519,0.515,1832,2390,0.767,1100,2842,3942,1979,645,407,1442,1757,9217,112.4