Rk,Team,G,MP,FG,FGA,FG%,3P,3PA,3P%,2P,2PA,2P%,FT,FTA,FT%,ORB,DRB,TRB,AST,STL,BLK,TOV,PF,PTS,PS_G
1,Phoenix Suns*,82,19730,3339,6788,0.492,730,1770,0.412,2609,5018,0.52,1631,2117,0.77,910,2616,3526,1912,479,418,1210,1713,9039,110.2
2,Golden State Warriors,82,19730,3329,7094,0.469,633,1687,0.375,2696,5407,0.499,1631,2085,0.782,753,2397,3150,1839,761,340,1204,1886,8922,108.8
3,Denver Nuggets*,82,19780,3124,6678,0.468,544,1517,0.359,2580,5161,0.5,1937,2508,0.772,889,2505,3394,1719,683,417,1136,1844,8729,106.5
4,Utah Jazz*,82,19755,3227,6575,0.491,439,1207,0.364,2788,5368,0.519,1654,2233,0.741,872,2588,3460,2187,675,400,1246,1859,8547,104.2
5,Toronto Raptors,82,19780,3199,6631,0.482,518,1397,0.371,2681,5234,0.512,1618,2118,0.764,806,2507,3313,1804,469,384,1100,1819,8534,104.1
6,Orlando Magic*,82,19730,3005,6394,0.47,841,2241,0.375,2164,4153,0.521,1575,2176,0.724,810,2736,3546,1615,512,456,1155,1629,8426,102.8
7,Memphis Grizzlies,82,19905,3223,6875,0.469,344,1020,0.337,2879,5855,0.492,1614,2202,0.733,1070,2496,3566,1543,645,399,1248,1655,8404,102.5
8,Houston Rockets,82,19905,3094,6923,0.447,646,1838,0.351,2448,5085,0.481,1561,2022,0.772,971,2471,3442,1790,583,318,1188,1712,8395,102.4
9,Cleveland Cavaliers*,82,19780,3101,6391,0.485,602,1582,0.381,2499,4809,0.52,1569,2180,0.72,791,2692,3483,1835,564,425,1137,1591,8373,102.1
10,New York Knicks,82,19880,3127,6876,0.455,743,2145,0.346,2384,4731,0.504,1376,1759,0.782,836,2477,3313,1772,586,305,1148,1638,8373,102.1
11,Dallas Mavericks*,82,19880,3140,6760,0.464,558,1498,0.372,2582,5262,0.491,1526,1870,0.816,834,2586,3420,1917,624,449,1059,1563,8364,102
12,Los Angeles Lakers*,82,19830,3144,6875,0.457,532,1562,0.341,2612,5313,0.492,1519,1985,0.765,973,2662,3635,1730,612,400,1096,1592,8339,101.7
13,Atlanta Hawks*,82,19855,3181,6801,0.468,524,1455,0.36,2657,5346,0.497,1452,1914,0.759,969,2451,3420,1789,592,413,980,1632,8338,101.7
14,Oklahoma City Thunder*,82,19805,3063,6629,0.462,418,1229,0.34,2645,5400,0.49,1778,2210,0.805,960,2607,3567,1639,654,481,1227,1743,8322,101.5
15,San Antonio Spurs*,82,19780,3150,6659,0.473,554,1547,0.358,2596,5112,0.508,1458,1969,0.74,887,2621,3508,1829,516,381,1116,1669,8312,101.4
16,Indiana Pacers,82,19705,3020,6823,0.443,659,1896,0.348,2361,4927,0.479,1564,2019,0.775,785,2618,3403,1730,585,439,1232,1848,8263,100.8
17,New Orleans Hornets,82,19830,3178,6842,0.464,571,1572,0.363,2607,5270,0.495,1293,1661,0.778,852,2450,3302,1828,625,300,1103,1606,8220,100.2
18,Sacramento Kings,82,19880,3144,6895,0.456,482,1383,0.349,2662,5512,0.483,1430,1969,0.726,977,2518,3495,1679,564,366,1226,1827,8200,100
19,Boston Celtics*,82,19780,3039,6294,0.483,499,1433,0.348,2540,4861,0.523,1559,2090,0.746,716,2449,3165,1930,701,402,1219,1816,8136,99.2
20,Minnesota Timberwolves,82,19780,3106,6923,0.449,403,1181,0.341,2703,5742,0.471,1436,1926,0.746,962,2556,3518,1626,597,306,1333,1699,8051,98.2
21,Portland Trail Blazers*,82,19855,2974,6453,0.461,491,1388,0.354,2483,5065,0.49,1606,2033,0.79,913,2383,3296,1674,523,350,1012,1715,8045,98.1
22,Philadelphia 76ers,82,19805,3087,6706,0.46,474,1381,0.343,2613,5325,0.491,1366,1808,0.756,941,2421,3362,1723,667,439,1192,1677,8014,97.7
23,Milwaukee Bucks*,82,19980,3050,6998,0.436,645,1813,0.356,2405,5185,0.464,1264,1675,0.755,965,2560,3525,1740,580,385,1085,1823,8009,97.7
24,Chicago Bulls*,82,19905,3081,6825,0.451,352,1066,0.33,2729,5759,0.474,1479,1962,0.754,937,2715,3652,1704,531,478,1175,1648,7993,97.5
25,Miami Heat*,82,19880,2984,6518,0.458,494,1426,0.346,2490,5092,0.489,1452,1931,0.752,875,2553,3428,1548,605,457,1079,1710,7914,96.5
26,Washington Wizards,82,19830,3008,6700,0.449,432,1225,0.353,2576,5475,0.471,1444,1895,0.762,966,2458,3424,1557,493,421,1219,1752,7892,96.2
27,Los Angeles Clippers,82,19705,3002,6601,0.455,483,1457,0.332,2519,5144,0.49,1362,1867,0.73,927,2502,3429,1810,532,466,1285,1581,7849,95.7
28,Charlotte Bobcats*,82,19880,2858,6306,0.453,460,1331,0.346,2398,4975,0.482,1637,2180,0.751,858,2490,3348,1658,632,446,1290,1597,7813,95.3
29,Detroit Pistons,82,19780,2940,6602,0.445,374,1190,0.314,2566,5412,0.474,1455,1998,0.728,1053,2242,3295,1591,596,313,1100,1822,7709,94
30,New Jersey Nets,82,19780,2813,6554,0.429,377,1185,0.318,2436,5369,0.454,1572,2015,0.78,897,2358,3255,1540,573,393,1182,1643,7575,92.4