Rk,Team,G,MP,FG,FGA,FG%,3P,3PA,3P%,2P,2PA,2P%,FT,FTA,FT%,ORB,DRB,TRB,AST,STL,BLK,TOV,PF,PTS,PS_G
1,Phoenix Suns*,82,19955,3430,7167,0.479,837,2097,0.399,2593,5070,0.511,1189,1475,0.806,778,2650,3428,2179,549,412,1088,1683,8886,108.4
2,Seattle SuperSonics,82,19830,3077,6711,0.459,605,1631,0.371,2472,5080,0.487,1652,2104,0.785,1013,2233,3246,1696,622,306,1208,1933,8411,102.6
3,Washington Wizards*,82,19830,2975,6656,0.447,497,1394,0.357,2478,5262,0.471,1889,2496,0.757,1035,2344,3379,1523,658,339,1143,1855,8336,101.7
4,Toronto Raptors,82,19955,3013,6639,0.454,608,1620,0.375,2405,5019,0.479,1653,2089,0.791,864,2291,3155,1593,529,272,1071,1965,8287,101.1
5,Denver Nuggets*,82,19930,3078,6672,0.461,350,1076,0.325,2728,5596,0.487,1721,2312,0.744,903,2486,3389,1921,698,463,1216,1863,8227,100.3
6,Miami Heat*,82,19755,3039,6355,0.478,497,1441,0.345,2542,4914,0.517,1616,2310,0.7,858,2675,3533,1692,522,442,1186,1871,8191,99.9
7,Philadelphia 76ers,82,19905,3001,6546,0.458,375,1031,0.364,2626,5515,0.476,1770,2330,0.76,873,2425,3298,1653,651,404,1159,1712,8147,99.4
8,Los Angeles Lakers*,82,19855,2992,6607,0.453,552,1583,0.349,2440,5024,0.486,1618,2172,0.745,970,2488,3458,1734,628,350,1143,1894,8154,99.4
9,Dallas Mavericks*,82,19880,2948,6375,0.462,416,1113,0.374,2532,5262,0.481,1818,2322,0.783,1030,2431,3461,1473,593,488,1112,1834,8130,99.1
10,Sacramento Kings*,82,19830,2954,6500,0.454,494,1408,0.351,2460,5092,0.483,1704,2173,0.784,852,2473,3325,1825,608,299,1199,1672,8106,98.9
11,Golden State Warriors,82,19830,2939,6785,0.433,625,1832,0.341,2314,4953,0.467,1573,2190,0.718,980,2485,3465,1694,604,357,1156,1941,8076,98.5
12,Boston Celtics,82,19880,2951,6322,0.467,467,1290,0.362,2484,5032,0.494,1664,2204,0.755,813,2432,3245,1716,578,422,1359,2033,8033,98
13,Milwaukee Bucks*,82,19855,2976,6566,0.453,507,1335,0.38,2469,5231,0.472,1561,2115,0.738,929,2448,3377,1769,597,270,1197,1902,8020,97.8
14,Chicago Bulls*,82,19905,3004,6737,0.446,560,1477,0.379,2444,5260,0.465,1452,1967,0.738,906,2602,3508,1804,508,345,1224,2038,8020,97.8
15,Cleveland Cavaliers*,82,19830,2908,6412,0.454,497,1465,0.339,2411,4947,0.487,1689,2318,0.729,959,2511,3470,1560,567,392,1137,1733,8002,97.6
16,Atlanta Hawks,82,19880,2946,6496,0.454,424,1154,0.367,2522,5342,0.472,1656,2207,0.75,1069,2232,3301,1625,587,394,1284,2054,7972,97.2
17,Los Angeles Clippers*,82,19805,2993,6443,0.465,290,843,0.344,2703,5600,0.483,1694,2142,0.791,828,2704,3532,1708,534,503,1185,1872,7970,97.2
18,Charlotte Bobcats,82,19905,2961,6843,0.433,428,1261,0.339,2533,5582,0.454,1593,2186,0.729,990,2270,3260,1717,822,354,1167,1960,7943,96.9
19,Detroit Pistons*,82,19830,2983,6558,0.455,557,1451,0.384,2426,5107,0.475,1418,1950,0.727,975,2347,3322,1971,580,490,931,1513,7941,96.8
20,New York Knicks,82,19930,2822,6206,0.455,320,884,0.362,2502,5322,0.47,1878,2587,0.726,1034,2360,3394,1468,555,271,1449,2157,7842,95.6
21,San Antonio Spurs*,82,19805,2993,6342,0.472,524,1362,0.385,2469,4980,0.496,1327,1891,0.702,851,2548,3399,1717,543,467,1126,1714,7837,95.6
22,Orlando Magic,82,19905,2911,6167,0.472,299,796,0.376,2612,5371,0.486,1663,2277,0.73,892,2402,3294,1495,532,362,1240,1908,7784,94.9
23,Indiana Pacers*,82,19730,2786,6274,0.444,536,1536,0.349,2250,4738,0.475,1591,2158,0.737,898,2559,3457,1631,598,409,1254,1821,7699,93.9
24,New Jersey Nets*,82,19780,2778,6317,0.44,477,1447,0.33,2301,4870,0.472,1658,2187,0.758,822,2539,3361,1884,558,278,1119,1903,7691,93.8
25,New Orleans/Oklahoma City Hornets,82,19805,2831,6428,0.44,300,885,0.339,2531,5543,0.457,1649,2176,0.758,918,2379,3297,1519,611,311,1095,1786,7611,92.8
26,Utah Jazz,82,19880,2744,6207,0.442,311,925,0.336,2433,5282,0.461,1774,2466,0.719,1071,2380,3451,1772,524,492,1290,2032,7573,92.4
27,Memphis Grizzlies*,82,19855,2746,6125,0.448,590,1578,0.374,2156,4547,0.474,1476,2077,0.711,834,2379,3213,1586,600,442,1134,1757,7558,92.2
28,Minnesota Timberwolves,82,19855,2888,6340,0.456,310,942,0.329,2578,5398,0.478,1436,1895,0.758,811,2422,3233,1716,559,471,1189,1889,7522,91.7
29,Houston Rockets,82,19830,2708,6252,0.433,469,1414,0.332,2239,4838,0.463,1502,1980,0.759,849,2565,3414,1580,588,320,1193,1863,7387,90.1
30,Portland Trail Blazers,82,19730,2791,6267,0.445,364,1042,0.349,2427,5225,0.464,1339,1944,0.689,886,2203,3089,1490,529,435,1205,1828,7285,88.8