Rk,Team,G,MP,FG,FGA,FG%,3P,3PA,3P%,2P,2PA,2P%,FT,FTA,FT%,ORB,DRB,TRB,AST,STL,BLK,TOV,PF,PTS,PA/G
1,San Antonio Spurs*,82,19705,2928,6709,0.436,541,1634,0.331,2387,5075,0.47,1221,1611,0.758,747,2576,3323,1707,592,317,1214,1597,7618,92.9
2,Utah Jazz,82,19955,2920,6549,0.446,649,1819,0.357,2271,4730,0.48,1374,1842,0.746,764,2522,3286,1568,652,385,1146,1629,7863,95.9
3,Toronto Raptors*,82,19780,2991,6732,0.444,717,1922,0.373,2274,4810,0.473,1354,1809,0.748,782,2561,3343,1781,534,442,1094,1801,8053,98.2
4,Cleveland Cavaliers*,82,19855,3019,6736,0.448,647,1862,0.347,2372,4874,0.487,1378,1855,0.743,760,2604,3364,1756,590,362,1092,1690,8063,98.3
5,Miami Heat*,82,19830,3054,6914,0.442,605,1742,0.347,2449,5172,0.474,1356,1761,0.77,803,2580,3383,1657,612,337,1060,1608,8069,98.4
6,Atlanta Hawks*,82,19830,3046,7058,0.432,679,2008,0.338,2367,5050,0.469,1366,1810,0.755,944,2869,3813,1808,706,411,1324,1500,8137,99.2
7,Los Angeles Clippers*,82,19830,3015,6946,0.434,645,1909,0.338,2370,5037,0.471,1543,2055,0.751,968,2861,3829,1740,583,259,1260,1842,8218,100.2
8,Indiana Pacers*,82,19880,3065,6962,0.44,679,2035,0.334,2386,4927,0.484,1428,1901,0.751,877,2774,3651,1707,634,366,1297,1676,8237,100.5
9,Charlotte Hornets*,82,19855,3098,6971,0.444,726,2081,0.349,2372,4890,0.485,1334,1735,0.769,726,2936,3662,1901,553,448,1103,1670,8256,100.7
10,New York Knicks,82,19805,3114,7035,0.443,626,1838,0.341,2488,5197,0.479,1435,1904,0.754,890,2733,3623,1703,589,343,927,1520,8289,101.1
11,Memphis Grizzlies*,82,19830,2947,6459,0.456,797,2185,0.365,2150,4274,0.503,1619,2107,0.768,830,2711,3541,1792,576,469,1328,1732,8310,101.3
12,Detroit Pistons*,82,19880,3182,6903,0.461,596,1679,0.355,2586,5224,0.495,1351,1726,0.783,725,2763,3488,1766,583,366,1099,1773,8311,101.4
13,Boston Celtics*,82,19780,3075,6973,0.441,643,1912,0.336,2432,5061,0.481,1613,2136,0.755,932,2838,3770,1715,622,450,1348,1718,8406,102.5
14,Dallas Mavericks*,82,20005,3144,6971,0.451,743,2170,0.342,2401,4801,0.5,1382,1873,0.738,868,2887,3755,1800,617,363,1142,1757,8413,102.6
15,Oklahoma City Thunder*,82,19830,3150,7192,0.438,667,1949,0.342,2483,5243,0.474,1474,1950,0.756,923,2373,3296,1767,719,373,1068,1653,8441,102.9
16,Chicago Bulls,82,19905,3234,7333,0.441,651,1885,0.345,2583,5448,0.474,1337,1813,0.737,969,2798,3767,1848,655,465,974,1535,8456,103.1
17,Milwaukee Bucks,82,19830,3097,6817,0.454,765,2171,0.352,2332,4646,0.502,1506,1961,0.768,942,2583,3525,2013,679,462,1269,1600,8465,103.2
18,Orlando Magic,82,19905,3150,6850,0.46,732,2041,0.359,2418,4809,0.503,1470,1971,0.746,832,2800,3632,1899,620,448,1240,1497,8502,103.7
19,Golden State Warriors*,82,19880,3188,7330,0.435,640,1928,0.332,2548,5402,0.472,1523,2013,0.757,937,2662,3599,1823,710,336,1185,1627,8539,104.1
20,Portland Trail Blazers*,82,19805,3146,6945,0.453,700,1888,0.371,2446,5057,0.484,1562,2129,0.734,867,2716,3583,1770,630,424,1088,1597,8554,104.3
21,Washington Wizards,82,19755,3170,6868,0.462,737,1987,0.371,2433,4881,0.498,1498,1947,0.769,773,2858,3631,1846,661,356,1325,1651,8575,104.6
22,Denver Nuggets,82,19830,3182,6904,0.461,754,2033,0.371,2428,4871,0.498,1491,1958,0.761,799,2700,3499,1924,660,517,1122,1712,8609,105
23,Minnesota Timberwolves,82,19880,3276,6962,0.471,742,2089,0.355,2534,4873,0.52,1394,1842,0.757,877,2558,3435,1857,638,427,1220,1768,8688,106
24,Brooklyn Nets,82,19755,3345,6984,0.479,775,2100,0.369,2570,4884,0.526,1227,1608,0.763,840,2719,3559,2006,720,430,1162,1510,8692,106
25,Houston Rockets*,82,19830,3200,6977,0.459,796,2206,0.361,2404,4771,0.504,1525,2018,0.756,970,2690,3660,2015,734,404,1360,1847,8721,106.4
26,New Orleans Pelicans,82,19780,3218,6877,0.468,754,2043,0.369,2464,4834,0.51,1544,1972,0.783,730,2912,3642,1899,602,423,1127,1630,8734,106.5
27,Los Angeles Lakers,82,19730,3323,7023,0.473,700,2016,0.347,2623,5007,0.524,1420,1942,0.731,897,2915,3812,2022,617,458,1037,1573,8766,106.9
28,Phoenix Suns,82,19705,3208,6870,0.467,770,2041,0.377,2438,4829,0.505,1631,2177,0.749,813,2770,3583,1837,782,449,1224,1770,8817,107.5
29,Philadelphia 76ers,82,19805,3253,7005,0.464,638,1776,0.359,2615,5229,0.5,1683,2141,0.786,913,2987,3900,1919,711,466,1241,1571,8827,107.6
30,Sacramento Kings,82,19805,3327,7194,0.462,839,2293,0.366,2488,4901,0.508,1450,1902,0.762,926,2765,3691,1986,722,437,1308,1800,8943,109.1